W	W	W	W	W	W	W	W	W	W	W	W	W	W	W
W	A	F	F	F	F	F	R	F	F	F	F	F	A	W
W	F	G	G	G	G	G	G	G	G	G	G	G	F	W
W	F	G	G	F	F	F	F	F	F	F	G	G	F	W
W	F	G	G	F	G	G	G	G	G	F	G	G	F	W
W	F	G	G	F	G	G	G	G	G	F	G	G	F	W
W	F	G	G	F	G	G	G	G	G	F	G	G	F	W
W	R	G	G	F	G	G	P	G	G	F	G	G	R	W
W	F	G	G	F	G	G	G	G	G	F	G	G	F	W
W	F	G	G	F	G	G	G	G	G	F	G	G	F	W
W	F	G	G	F	G	G	G	G	G	F	G	G	F	W
W	F	G	G	F	F	F	F	F	F	F	G	G	F	W
W	F	G	G	G	G	G	G	G	G	G	G	G	F	W
W	A	F	F	F	F	F	R	F	F	F	F	F	A	W
W	W	W	W	W	W	W	W	W	W	W	W	W	W	W